##########
#O ####  #
# X####  #
#        #
######   #
#  ####  #
#        #
#   ######
#         
##########